NO ./textures/cobble-wall.xpm
SO ./textures/cobble-wall.xpm
WE ./textures/blue-cobble-wall.xpm
EA ./textures/blue-cobble-wall.xpm

F 220,100,0
C 225,30,0

11111111111111111111
100000000000000000W1
11111111111111111111