NO ./textures/cobble-wall.xpm
SO ./textures/cobble-wall.xpm
WE ./textures/cobble-wall.xpm
EA ./textures/cobble-wall.xpm
D ./textures/metal_door.xpm

F 220,100,0
C 225,30,0

111111111111111111111111
100000000000000001000001
1001010D0D0D0D0001000001
1000000000DDDDD00D0000W1
101010D0D00D0D0001000001
100000000000000001000001
111111111111111111111111