NO ./textures/cobble-wall.xpm
SO ./textures/cobble-wall.xpm
WE ./textures/cobble-wall.xpm
EA ./textures/cobble-wall.xpm
D ./textures/metal_door.xpm

F 220,100,0
C 225,30,0

111111111111111111111111
100000000000000001000001
100000000000000001000001
100000000D0000000D0000W1
100000000000000001000001
100000000000000001000001
111111111111111111111111