NO ./textures/cobble-wall.xpm
SO ./textures/cobble-wall.xpm
WE ./textures/cobble-wall.xpm
EA ./textures/cobble-wall.xpm
D ./textures/blue-cobble-wall.xpm

F 220,100,0
C 225,30,0

1111111111111111111
1000000001000000001
1000000001000000001
100000000D0000000W1
1000000001000000001
1000000001000000001
1111111111111111111