NO ./textures/cobble-wall.xpm
SO ./textures/cobble-wall.xpm
WE ./textures/blue-cobble-wall.xpm
EA ./textures/blue-cobble-wall.xpm

F 220,100,0
C 225,30,0

11111111111111111111
11000000000000000011
11011111111111111011
11010000000000001011
11010111111111101011
11010100000000101011
11010101111110101011
11010101000010101011
11010101011010101011
11010101011010101011
11010101000010101011
11010101111110101011
11010100000000101011
11010111111111101011
11010000000000001011
11011111111111111011
11000000000000000W11
11111111111111111111
