NO ./textures/cobble-wall.xpm
SO ./textures/wooden_wall.xpm
WE ./textures/marble_wall.xpm
EA ./textures/blue-cobble-wall.xpm
D ./textures/metal_door.xpm

F 220,100,0
C 225,30,0


                1111
11111111111111110001
10000001000000000101
10110010000100111001
10101010001101010001
10101011000010100001
10101010011111101001
10101D10000000101001
10100000011111101001
10101010000010101001
10101010001111101001
10001110000000101001
11101010001111101001
10101010001111001001
10101010000100001001
10101010111110001001
10101000010000101001
10111011111101111001
10000000100D00000N01
11111111111111111111