NO ./textures/cobble-wall.xpm
SO ./textures/cobble-wall.xpm
WE ./textures/cobble-wall.xpm
EA ./textures/cobble-wall.xpm
D ./textures/metal_door.xpm

F 220,100,0
C 225,30,0

111111111111111T1T1T1111
T000000000000010101010S1
1111T0000000000000001001
T00000000000000000001001
1111T00000000000000011D1
T00000000000000000000001
1111T0000000000000000001
T00000000000000000000001
111111111111111111111111